20 20
256 256

2 2 2 2 2 2 2 2 2 2 2 2 2 2 2 2 2 2 2 2
2 1 1 1 1 1 1 1 1 1 1 1 1 1 1 1 1 1 1 2
2 1 1 1 1 1 1 85 1 1 1 1 1 71 1 1 1 1 1 2
2 1 1 1 1 1 1 1 1 1 1 1 1 1 1 1 1 1 1 2
2 1 1 85 1 1 1 1 1 1 1 1 71 1 72 1 1 1 1 2
2 1 1 1 1 1 1 1 1 1 1 1 1 1 1 1 1 1 1 2
2 1 1 1 1 1 1 1 1 1 1 1 1 1 1 1 1 1 1 2
2 1 1 1 1 1 1 1 1 1 85 1 1 1 1 1 1 1 1 2
2 1 1 1 71 1 1 1 1 1 1 1 1 1 1 1 1 1 1 2
2 1 1 1 1 85 1 1 1 1 1 1 1 1 85 1 1 1 1 2
2 1 1 71 1 1 1 1 1 1 72 1 1 1 1 1 1 1 1 2
2 1 1 1 1 1 1 1 1 1 1 1 1 1 1 1 1 1 1 2
2 1 72 1 1 1 1 1 85 1 1 1 1 85 1 1 1 1 1 2
2 1 1 85 1 1 1 72 1 1 1 1 1 1 1 71 1 1 1 2
2 1 1 1 1 1 1 1 1 1 1 1 1 1 1 1 1 1 1 2
2 1 1 1 1 1 1 1 1 1 85 1 1 1 1 1 1 1 1 2
2 1 1 1 1 1 1 1 1 1 1 1 1 1 1 72 1 1 1 2
2 1 1 85 1 1 71 85 1 1 1 1 1 1 1 1 1 1 1 2
2 1 1 1 1 1 1 1 1 1 1 1 1 1 1 1 1 1 1 2
2 2 2 2 2 2 2 2 2 2 2 2 2 2 2 2 2 2 2 2
